1111111111111
10010000000C1
1000011111001
1PC0110000001
1000000CE0001
100C000000001
1111111111111
