111111111
100000001
10P0E00C1
1000000C1
111111111
