1111111
1P0C001
11CCC11
100CCE1
1111111