1111111111111
10010000000C1
1000011011001
100P11E0C0001
1111111111111
