11111111111111111111111111111111111
1P000000000000C00000000000000000001
11111111111111111111111111111111001
10000000000000010000000000000000001
10011111111110011001111111111111111
100100000000100100000000000000000C1
11110000000000010000000000000000001
11011111111111000000001111111111001
11000000000000111111110000000000011
11101111111111111111110111111111111
111000000000000000000000000000000E1
11111111111111111111111111111111111
