11111111111111111111111111111111111
100001000000000P0100000000000000001
10001E10000000000000000000000000001
10000000000000000000000000000000001
11111111111110011111111111111111111
100100000000100100000000000000000C1
11010000000010010000000000000000001
11011111111111000000001111111111001
11000000000000111111110000000000C11
11101111111111111111110111111111111
11100000000000000000000000000000001
11111111111111111111111111111111111
