111111111111
1P0000000001
111CCCCCC011
100000000001
11100000CCC1
100000000001
1100000000E1
111111111111
